OOOOOOOOOOOOOOOOOOOOOOOOOOOOOOOO
OOOOOOOOOOOOOOOOOOOOOOOOOOOOOOOO
RRRRRRRRRROOOGOOOOOOOOOOOOOOOOOO
LOOOOOOOOOOLBBBBBBBBBBLOOOOOOOOO
LOOEOOOOOOOLOOOOOOOOOOLOOOEOOOOO
BBBBBBBLOOOLOOOOOOOOOOLSSSSSSSSS
OOOOOOOLOOOLOOOOOOOOOOLOOOOOOOOO
OOOOOOOLOOOLOOOOOGOOOOLOOOOOOOOO
OOOOOOOLBBBBBBLBBBBBLBBOOOOOOOOO
OOGOOOOLOOOOOOLOOOOOLOORROOOOOOO
BBBBBBLBOOOOOOLOOOOOLOOOORROOOOO
OOOOOOLOOOOLBBBBBBLBBOOOOOORROGO
OOOOOOLRRRRLOOOOOOLOOOOOOOOOOBBB
OOOOOOLOOOOOOOLBBBBBBBBBBLOOOOOO
OOOOOOLOOOOOOOLBBBBBBBBBBLOOOOOO
OOOOOOLOOOOEOOLBBBBBBBBBBLOOOOOO
BBBBBLBBBBBBBBBBOOOOOOOOBBBBLBBB
BBBBBLBBBBBBBBBBOOOOGOOOBBBBLBBB
BBBBBLBBBBBBBBBBOLBBBBLOBBBBLBBB
OOOOOLOOOOOOOOOOOLBBBBLOOOOOLOOO
OOOOOLOOOOHOOOOOOLBBBBLOOGOOLOOO
BBBBBBBBBBBBBBBBBBBBBBBBBBBBBBBB