OOOOOOOOOOOOOOOOOOOOOOOOOOOOOOOO
OOOGOOOOOOOOOOOOOOOOOOOOOOOOOOOO
LSSBSSLOOOOOOOOOOOOOOOGOOOOOOOOO
LOOOOOLOOOOOOLBBBBBBBBBBBLOOOOOO
LOGOEOLOOOOOOLOOOOOOOOOOOLOGOOOO
LBSBSBLOOOOOOLOOOOOOOOOOOLBBBBBO
LOOOOOLRRROOOLOOOOOOOOOOOLOOOOOO
LOOOOOLOOOOOOLOOOOOOOOOOOLOOOOOO
LOOOOOLRRRRRRLRRRRRRROOOELOOOOOO
LOOOOOLOOOOOOLOOOOOOLBBBBSSSSSSL
LOOOOOLOOOOOOLOOOOOOLOOOOOOOOOOL
LOOOOOLOOOOOOLOOGOOOLOOOOOOOOOOL
LOOOEOLOGOOOOLBBBBBBLOOOOOOOOOOL
SSBBBSBSSBBSSLOOOOOOOOOOOOOOOOOL
SBBBSSOOOOOOOLOOOOOOOOOOLBBBBLBB
SOOOSSOOOOOOOLOOOOOOOOOOLOOOOLOO
SGOOSSOOOOOOOLOOORRRRRRRLOOOOLOG
BBBBBBBBBLBBBBSSSSOOOOOOLOOOBBBB
OOOOOOOOOLOOOOOOOOOOOOOOLOOOOOOO
OOOOOOOOOLOOOOOOOOOOOOOOLOOOOOOO
OOOOOOOOOLOOOOOOOHOOOOOOLOOOOOOO
BBBBBBBBBBBBBBBBBBBBBBBBBBBBBBBB