SSSSSSSSSSSSSSSSSSSSSSSSSSSSSSSS
SGGGGGGGGGGGGGGSSGGGGGGGGGGGGGGS
SLSSSSLSSSSLSSLSSLSSLSSSSLSSSSLS
SLGGGGLGGGGLGGLGGLGGLGGGGLGGGGLS
SLSSSSLSSLSSSSSSSSSSSSLSSLSSSSLS
SLGGGGLSSLGGGGLSSLGGGGLSSLGGGGLS
SSSSSSLSSSSSSSLSSLSSSSSSSLSSSSSS
OOOOOSLSSLGGGGLGGLGGGGLSSLSOOOOO
OOOOOSLGGLSSSSSLLSSSSSLGGLSOOOOO
OOOOOSLSSLSOOEOLLOEOOSLSSLSOOOOO
OOOOOSLGGLSOOOELLEOOOSLGGLSOOOOO
OOOOOSLSSLSSSSSLLSSSSSLSSLSOOOOO
OOOOOSLGGLGGGGGLLGGGGGLGGLSOOOOO
OOOOOSLSSLSSSSLSSLSSSSLSSLSOOOOO
OOOOOSLGGLGGGGLGGLGGGGLGGLSOOOOO
SSSSSSLSSSSSSSLSSLSSSSSSSLSSSSSS
SLGGGGLSSLGGGGLSSLGGGGLSSLGGGGLS
SLSSSSLSSLSSSSSSSSSSSSLSSLSSSSLS
SLGHGGLGGLGLGGLGGLGGLGLGGLGGGGLS
SLSSSSLSSSSLSSLSSLSSLSSSSLSSSSLS
SLGGGGLGGGGLGGLSSLGGLGGGGLGGGGLS
SSSSSSSSSSSSSSSSSSSSSSSSSSSSSSSS