SSSSSSSSSSSSSSSSSSSSSSSSSSSSSSSS
SOOOOOOOOOOOOOOSSOOOOOOOOOOOOOOS
SLSSSSLSSSSLSSLSSLSSLSSSSLSSSSLS
SLOOOOLOOOOLOOLOOLOOLOOOOLOOOOLS
SLSSSSLSSLSSSSSSSSSSSSLSSLSSSSLS
SLOOOOLSSLOOOOLSSLOOOOLSSLOOOOLS
SSSSSSLSSSSSSSLSSLSSSSSSSLSSSSSS
OOOOOSLSSLOOOOLOOLOOOOLSSLSOOOOO
OOOOOSLOOLSSSSSLLSSSSSLOOLSOOOOO
OOOOOSLSSLSOOOOLLOOOOSLSSLSOOOOO
OOOOOSLOOLSEOEOLLOEOESLOOLSOOOOO
OOOOOSLSSLSSSSSSSSSSSSLSSLSOOOOO
OOOOOSLOOLOOOOOOOOOOOOLOOLSOOOOO
OOOOOSLSSLSSSSLSSLSSSSLSSLSOOOOO
OOOOOSLOOLOOOOLOOLOOOOLOOLSOOOOO
SSSSSSLSSSSSSSLSSLSSSSSSSLSSSSSS
SLOOOOLSSLOOOOLSSLOOOOLSSLOOOOLS
SLSSSSLSSLSSSSSSSSSSSSLSSLSSSSLS
SLOOOOLOOLOLOOLOOLOOLOLOOLOOOOLS
SLSSSSLSSSSLSSLSSLSSLSSSSLSSSSLS
SLOOOOLOOOOLOOLSSLOOLOOOOLOOOOLS
SSSSSSSSSSSSSSSSSSSSSSSSSSSSSSSS