OOOOOOOOOOOOOOOOOOOOOOOOOOOOOOOO
ORRRRRRRRRRRRRROOOOOOOOOOOOOOOOO
LOOOOOOOOLOOOOOBOGOBOOOOOLOOOOOO
LOOOOOOOLLLOOOOBBBBBOOOOLLLOOOOO
LOOOOGOOOLOOOGOOOOOOOGOOOLOOOOOO
LOOOOLLOOLOOLLOOOOOOOLLOOLOOLLOO
LOOOOLOLLLLLOLOOOOOOOLOLLLLLOLOO
LOOOOLOLLLLLOLOOOLOOOLOLLLLLOLOO
LOOOOLOOGOGOELOOLLLOOLEOGOGOOLOO
LOOOOOLBBBBBLOOOOLOOOOLBBBBBLOOO
LOOOOOOLLLLLOLLOOLOOLLOLLLLLOOOO
LOOOOOOOOOOOOLOLLLLLOLOOOOOOOOOO
LOOOOOOOOOOOOLOLLLLLOLOOOOOOOOOO
LOOOOOOOOOOOOLOLLLLLOLOOOOOOOOOO
LOOOOOOOOOOOOLOOGOGEOLOOOOOOOOOO
LOOOOOOGOOOOOOLBBBBBLOOOOOOGOOOO
LBBBBBBBBLOOOOOLLLLLOOOOOLBBBBBB
LOOOOOOOOLOOOOOOOOOOOOOOOLOOOOOO
LOOOOOOOOLOOOOOOOOOOOOOOOLOOOOOO
LOOOOOOOOLOOOOOOOOOOOOOOOLOOOOOO
LOOOOOOOOLOOOOOOOHOOOOOOOLOOOOOO
BBBBBBBBBBBBBBBBBBBBBBBBBBBBBBBB