OOOOOOOOOOOOOOOOOOOOOOOOOOOOOOOL
OOOOOOOOOOOOOOOOOOOOOOOOOOOOOOOL
LSSBSSLOOOOOOOOOOOOOOOOOOOOOOOOL
LOOOOOLOOOOOOLBBBBBBBBBBBLOOOOOL
LOOOOOLOOOOOOLOOOOOOOOOOOLOOOOOL
LBSBSBLOOOOOOLOOOOOOOOOOOLBBBBBL
LOOOOOLRRROOOLOOOOOOOOOOOLOOOOOO
LOOOOOLOOOOOOLOOOOOOOOOOOLOOOOOO
LOOOOOLRRRRRRLRRRRRRROOOOLOOOOOO
LOOOOOLOOOOOOLOOOOOOLBBBBSSSSSSL
LOOOOOLOOOOOOLOOOOOOLOOOOOOOOOOL
LOOOOOLOOOOOOLOOOOOOLOOOOOOOOOOL
LOOOOOLOOOOOOLBBBBBBLOOOOOOOOOOL
SSBBBSBSSBBSSLOOOOOOOOOOOOOOOOOL
SBBBSSOOOOOOOLOOOOOOOOOOLBBBBLBB
SOOOSSOOOOOOOLOOOOOOOOOOLOOOOLOO
SOOOSSOOOOOOOLOOORRRRRRRLOOOOLOO
BBBBBBBBBLBBBBSSSSOOOOOOLOOOBBBB
OOOOOOOOOLOOOOOOOOOOOOOOLOOOOOOO
OOOOOOOOOLOOOOOOOOOOOOOOLOOOOOOO
OOOOOOOOOLOOOOOOOOOOOOOOLOOOOOOO
BBBBBBBBBBBBBBBBBBBBBBBBBBBBBBBB