OOOOOOOOOOOOOOOOOOOOOOOOOOOOOOOO
OOOOOOOGOOOOOOOEOOOOOOOOOOOOOOOO
BSSBSSBSSSBLBBBBBBSOOOOOOOOOOOOO
OOOOOOOOOOOLRRRRRRRRRRROOOOOOOOO
OOOOOOOOOOOLOOOOBBLOOOOOOOOOOOOO
OOOOOOOOOOOLOOOOBBLOOOOOOGOOOOOO
OOOOOOOOOOOLOOOOBBLOOOBBBBBLBBBB
OOOOOOOOOOOLOOOOBBLOOOOOOOOLOOOO
OOOOOOOOOOOLOOOOBBLOOOOOOOOLOOOO
OOOOOOOOOOOLOOOOBBLOOOOOOOOLOEOO
BBBLBBBBBBBBOOOOBBBBBBBBLBBBBBBB
OOOLOOOOOOOOOOOOOOOOOOOOLOOOOOOO
OOOLOOOOOOOOOOOOOOOOOOOOLOOOOOOO
OOOLOOOEOOOOOOOOOOOOOOOOLOOOOOOO
BBBBBBBBBBBBBBLBBBBBBBBBLOOOOOOO
OOOOOOOOOOOOOOLOOOOOOOOOLOOOOOOO
OOOOOOOOOOOOOOLOOOOOOOOOLOOOOOOO
OOOOOOOOOOOGOOLRRRRRRRRRLOOOGOOO
OOOOOOLBBBBBBBBBOOOOOOOOBBBBBBBL
OOOOOOLOOOOOOOOOOOOOOOOOOOOOOOOL
OOOOOOLOOOOOOOOOHOOOOOOOOOOOOOOL
BBBBBBBBBBBBBBBBBBBBBBBBBBBBBBBB