OOOOOOOOOOOOOOOOOOOOOOOOOOOOOOOL
OOOOOOOOOOOOOOOOOOOOOOOOOOOOOOOL
RRRRRRRRRROOOOOOOOOOOOOOOOOOOOOL
LOOOOOOOOOOLBBBBBBBBBBLOOOOOOOOL
LOOOOOOOOOOLOOOOOOOOOOLOOOOOOOOL
BBBBBBBLOOOLOOOOOOOOOOLSSSSSSSSS
OOOOOOOLOOOLOOOOOOOOOOLOOOOOOOOO
OOOOOOOLOOOLOOOOOOOOOOLOOOOOOOOO
OOOOOOOLBBBBBBLBBBBBLBBOOOOOOOOO
OOOOOOOLOOOOOOLOOOOOLOORROOOOOOO
BBBBBBLBOOOOOOLOOOOOLOOOORROOOOO
OOOOOOLOOOOLBBBBBBLBBOOOOOORROOO
OOOOOOLRRRRLOOOOOOLOOOOOOOOOOBBB
OOOOOOLOOOOOOOLBBBBBBBBBBLOOOOOO
OOOOOOLOOOOOOOLBBBBBBBBBBLOOOOOO
OOOOOOLOOOOOOOLBBBBBBBBBBLOOOOOO
BBBBBLBBBBBBBBBBOOOOOOOOBBBBLBBB
BBBBBLBBBBBBBBBBOOOOOOOOBBBBLBBB
BBBBBLBBBBBBBBBBOLBBBBLOBBBBLBBB
OOOOOLOOOOOOOOOOOLBBBBLOOOOOLOOO
OOOOOLOOOOOOOOOOOLBBBBLOOOOOLOOO
BBBBBBBBBBBBBBBBBBBBBBBBBBBBBBBB