OOOOOOOOOOOOOOOOOOOOOOOOOOOOOOOL
OOOOOOOOOOOOOOOOOOOOOOOOOOOOOOOL
BSSBSSBSSSBLBBBBBBSOOOOOOOOOOOOL
OOOOOOOOOOOLRRRRRRRRRRROOOOOOOOL
OOOOOOOOOOOLOOOOBBLOOOOOOOOOOOOL
OOOOOOOOOOOLOOOOBBLOOOOOOOOOOOOL
OOOOOOOOOOOLOOOOBBLOOOBBBBBLBBBB
OOOOOOOOOOOLOOOOBBLOOOOOOOOLOOOO
OOOOOOOOOOOLOOOOBBLOOOOOOOOLOOOO
OOOOOOOOOOOLOOOOBBLOOOOOOOOLOOOO
BBBLBBBBBBBBOOOOBBBBBBBBLBBBBBBB
OOOLOOOOOOOOOOOOOOOOOOOOLOOOOOOO
OOOLOOOOOOOOOOOOOOOOOOOOLOOOOOOO
OOOLOOOOOOOOOOOOOOOOOOOOLOOOOOOO
BBBBBBBBBBBBBBLBBBBBBBBBLOOOOOOO
OOOOOOOOOOOOOOLOOOOOOOOOLOOOOOOO
OOOOOOOOOOOOOOLOOOOOOOOOLOOOOOOO
OOOOOOOOOOOOOOLRRRRRRRRRLOOOOOOO
OOOOOOLBBBBBBBBBOOOOOOOOBBBBBBBL
OOOOOOLOOOOOOOOOOOOOOOOOOOOOOOOL
OOOOOOLOOOOOOOOOOOOOOOOOOOOOOOOL
BBBBBBBBBBBBBBBBBBBBBBBBBBBBBBBB